NO ./texture/north.xpm
          SO ./texture/south.xpm
WE ./texture/west.xpm
EA ./texture/east.xpm

F          120,30,5
F          88,30,33


1111111111111111111111111
1111111111111111111111111
10000000110000000000001111
110011000001110000000000001111111111
1100100000000000000000000111110000001
111111111011000001110000000000001111
     100000000011000001110111111111111
11111111111111111111111111111111111111                                           
111111111111111111111111111111111111111
 11110111111111011100000010001
11110111111111011101010010001
11000000110101011100000010001
100000000000000001100000010001
10000000000000011010100100011
1100000111010101111101111000111
11110111 1110101010111101N0011
11111111 111111111111111111111



00000000000000000000000000000101
