NO ./texture/north.xpm
SO ./texture/south.xpm
WE ./texture/west.xpm
EA ./texture/east.xpm


F 120,30,5
C 120,30,5


1111111111111111111111111
1111111111111111111111111
100000000110000000000001111
110011000001110000000000001111111111
1100100000000000000000111110000001
1111111110110000011100000000001111
     1000000000110000111011111
 1111011111111011100000010001
1111011111111011110100100011
110000001100101110100001001
100000000000000001000010001
1000000000000001101010100011
11000001110101011111011110011
11110111 1110101010111100011
11111111 111111111111111111111
