11111111111111111111
10000000000000000001
10P0C000011111000001
1000CC00010001000001
10000CC0010E01000001
100000CC01CC01000001
1000000CCCC000000001
11111111111111111111