1111111111
1000000001
1E000C00P1
1000000001
1111111111